
 .........................................................................
 .........................................................................
 .......###############........................###################........
 .......#........................................................#........
 .......#........................................................#........
 .......#........................................................#........
 .......#........................................................#........
 .......#........................................................#........
 .........................................................................
 ........................#########....#########...........................
 ........................#....................#...........................
 ........................#....................#...........................
 ........................#....................#...........................
 ........................#....................#...........................
 ........................#########....#########...........................
 .........................................................................
 .........................................................................
 .......#.........................................................#.......
 .......#.........................................................#.......
 .......#.........................................................#.......
 .......#.........................................................#.......
 .......#.........................................................#.......
 .......#.........................................................#.......
 .......#.........................................................#.......
 .......###################.....................###################.......
 .........................................................................
 .........................................................................