
 .......................................................................
 .......................................................................
 ....#############################.....############################.....
 ....#............................................................#.....
 ....#............................................................#.....
 ....#............................................................#.....
 ....#.........#########.......................#########..........#.....
 ....#.......##.........##...................##.........##........#.....
 ....#............................................................#.....
 ....#.......##.........##...................##.........##........#.....
 ....#.........#########.......................#########..........#.....
 .......................................................................
 .......................................................................
 .......................................................................
 ....#............................................................#.....
 ....#............................................................#.....
 ....#............................................................#.....
 ....#............................................................#.....
 ....#............................................................#.....
 ....#....................####################....................#.....
 ....#............................................................#.....
 ....#............................................................#.....
 ....#............................................................#.....
 ....#############################.....############################.....
 .......................................................................
 .......................................................................